Width: 9 tiles
Height: 15 tiles

Map:
  012345678
0 ╔═══════╗
1 ║       ║
2 ║ ╔═══╗ ║
3 ║ ║   ║ ║
4 ║ ║ ╔═╝ ║
5 ║ ║ ║   ║
6 ║ ║ ║ ╔═╝
7 ║ ║ ║ ║  
8 ║ ║ ║ ╚═╗
9 ║ ║ ║   ║
10╚═╝ ╚═╗ ║
11      ║ ║
12╔═════╝ ║
13║       ║
14╚═══════╝
